00000000000000000000
00000000000000000000
00000000000000000000
00000000000000000000
00000000000000000000
11111111000000000000
10207001000000000000
10000001000000000000
10000001000000000000
10000001000000000000
1000m001000000000000
10000001111100000000
10000000o0a100000000
10000000o0a100000000
10000000o0a100000000
10000000o0a100000000
10900070o0a100000000
10000000o0a100000000
10007000o0a100000000
11111111111100000000
150
Tutorial 7:
The violet switch opens or closes the
violet Blocks like doors.
