11111111111111111111
10283230000020000071
10004500000002000701
100o2340000000007001
100o0434000000070001
1b0o4343400000700001
100o3434340000000001
100o4343434000000001
1004343434340f0a0001
10034301434340000001
100034f0343434000001
10005251434343400001
10052523143434340001
145252gm114343434501
15251051123434m43251
12511431254343206511
16083147512834525111
10004325b25143251111
10051451451114511111
11111111111111111111
150
Diagonal
