00000000000000000000
00000000000000000000
00000000000000000000
11111111111110000000
10000000000010000000
10a00000003010000000
10000000000010000000
11111111000010000000
10000001000010000000
10000001000010000000
10000001000010000000
10000001000010000000
10000a01000010000000
10000g01000010000000
10000001000010000000
10000001000010000000
10000001000010000000
10000001000010000000
10000900005010000000
11111111111110000000
150
Tutorial 3:
The white block seams so near, but there
are things that go beyond your vision.
