gggggggggggggggggggg
g000000000000000000g
g000000000000000000g
g000000000000000000g
g000000000000000000g
g000000000000000000g
g0a0000000000000000g
gag0100000000000000g
gd00000000300000000g
g20000mo03000000000g
g000060o30000000000g
g000g0a000000000000g
g0d0b00000000000000g
g00gk000000gm100000g
g020300000000000000g
gh00000300000000000g
g90j500000000000000g
g4m000n000500000000g
ggmh0jnk0gb10000000g
gggggggggggggggggggg
100
Reaction Speed
