00000000000000000000
00000000000000000000
00000000000000000000
00000000000000000000
00000000000000000000
11111111111110000000
10000000000010000000
10200300000010000000
10000000000010000000
10000000000010000000
10000000000010000000
10000000000010000000
10000000000010000000
10400000030010000000
10000000000010000000
10000000000010000000
10000a00000010000000
10000000000010000000
10000000050010000000
11111111111110000000
150
Tutorial 1:
Use the mouse to adjust the view.
Your ship always moves straight on, it just
bounces off the prisms. Fly into the white
block to advance to the next level.
  
Press any key to start.
