00000000000000000000
00000000000000000000
00000000000000000000
00000000000000000000
00000000000000000000
00000000000000000000
00000000000000000000
00000000000000000000
11111111111111110000
10000000000000010000
10000000000000010000
10e0c000000000010000
10000000000000010000
1000a000000000010000
104000c00g0000010000
10000000000000010000
10000000000000010000
10000000000000010000
10000090000000b10000
11111111111111110000
150
Tutorial 4:
The red prisms can be rotated by flying
over the red switch plate. They can't be
rotated by shooting them. Also the switch
plate is only triggered by you, not by
your bullets.
