00000000000000000000
00000000000000000000
00000000000000000000
00000000000000000000
00000000000000000000
11111111111111111111
1000002000000b000071
100000i0000300000001
10000000000000000001
10000000000j000800b1
10000000000000000011
10000000000000000001
10000000000000000001
100000j0000600000001
10000000000000000001
10000000000000000001
10000000000000000001
10000000000g00000001
100000f0000ag00i0001
11111111111111111111
150
Scattered elements
  
Remember that the red prisms rotate
clockwise.
