gggggggggggggggggggg
g200000000b00000003g
gb00000000g0020003bg
g020000000000000300g
g00d000000000003000g
g000000000i00000000g
g000000000000000000g
g0000n0000000000000g
g0000m0000000000000g
g000d00000k00000000g
g000000000000000000g
g000000k00000005000g
g000000m00000000000g
g000000b00000000000g
g000700mo0000000900g
g0000i0b00000000000g
g080000j00400j00050g
gb0a00000000000000bg
g400000900000000005g
gggggggggggggggggggg
150
Feasible
