11232323232323232311
20000000000006000091
400000000000000000g1
20000000000600009ga1
40000000000000000go1
20000000060000900gb1
40000000000000000gm1
20000006000090000gb1
400000000000000000m1
20000600009000060gb1
40000000000000000gm1
20060000900006000gb1
40000000000000000gm1
26000090000600000gb1
40000000000000000gm1
20009000060000000gb1
40000000000000000gm1
109000000000000000b1
100070707070707070c1
11111111111111111111
170
Fun Land
