00000000000000000000
00000000000000000000
00000000000000000000
00000000000000000000
00000000000000000000
00000000000000000000
00000000000000000000
00000000000000000000
00000000000000000000
00000000000000000000
00000000000000000000
00000000000000000000
11111111111110000000
100i0000000310000000
10000000000010000000
10000000000010000000
100i00a0000010000000
10000000000010000000
10000000000510000000
11111111111110000000
150
Tutorial 6:
When a teleporter is used, it gets
unusable for a moment. If you shoot a
bullet through a teleporter just before
you would get teleported yourself, you
can bypass the teleporter.
