00000000000000000000
00000000000000000000
00000000000000000000
00000000000000000000
00000000000000000000
52311111111140000000
140lg00000k311123400
1k000000000000h05100
10000000000000000140
1400007000000c000314
1l000000000000060001
12000000005400000031
10400070003m00000051
100i1h00000000060001
1400o000000000000091
1340o07000m03b000001
1j34o0000000050600i1
1aaa10000000000000g1
100000500040f00000j1
31111111111111111112
250
Many Happy Returns

