11111111111111111111
12000000000000000031
10000000054000000001
16020060032006003001
10000000000000000001
18090200000000300001
10000000000000000001
1607g00d000030000001
1000000000b000000001
1809000002300g000001
10000000045000000001
16070000000000500001
10000000000000000001
18090000000000005001
1gggggj0ggg008000001
19000000000800000001
10aaaagaaaa0j0g00071
170h0gag0i0600000001
100h0gag0i0006000051
11111111111111111111
360
Vortex
