11111111111111111111
12000000000000000031
10000000000000000001
10000000000000000001
10002070000000007001
18000000002000000001
10000000000000000001
10000000000000000001
10000000000000000001
1400700040a030000001
10000000000000000001
10000000000000000001
10000000000000000001
10000000005000070001
10000000000000000001
10000000000000000001
10000000000000000001
10007000009090000001
10000000000000005051
11111111111111111111
100
Some simple bouncing
