00000000000000000000
00000000000000000000
00000000000000000000
00000000000000000000
00000000000000000000
00000000000000000000
00000000000000000000
00000000000000000000
11111111111000000000
10000000001000000000
10000000001000000000
10000000001000000000
10a00060001000000000
10000000001000000000
10000000001000000000
10000000001000000000
10000000001000000000
10000000001000000000
10000050001000000000
11111111111000000000
150
Tutorial 2:
When flying, press the space bar or the
left mouse button to fire a bullet.
When the bullet hits a yellow prism, the
prism is rotated. Shoot the prism to
move into the white block.
