00000000000000000000
00000000000000000000
00000000000000000000
00000000000000000000
00000000000000000000
00000000000000000000
00000000000000000000
00000000000000000000
00000000000000000000
00000000000000000000
00000000000000000000
11111111111100000000
10000000000100000000
10h00000090100000000
10000000000100000000
10a00000000100000000
10000000000100000000
10000000000100000000
100000000h0100000000
11111111111100000000
150
Tutorial 5:
The little pyramids are teleporters.
They teleport you and your bullets between
each other. Note that you keep your
current direction when going through a
teleporter.
